R  1920 1080

NO textures/pix1.xpm
SO textures/pix1.xpm
WE textures/pix1.xpm
EA textures/pix1.xpm

S textures/barrel.xpm

F 245,246,250
C 245,246,250

1111111111111111111111111111111111111
1000000000000020000W10000000000000001
1001111111111001111010000000000000001
100100000001001001001000000000000001
1001001100001001000100100000000000001
100100110000010010010010000000000001
1001001100000010010001001000000000001
1001001000000010011111100100000000001
1001001111111110000000000011111111111
1000000000000000111111111110000000021
1111111111111111111111111111111111111