R  1920 1080

NO ./path_to_the_north_texture
SO ./path_to_the_south_texture
WE ./path_to_the_west_texture
EA ./path_to_the_east_texture

S ./path_to_the_sprite_texture

F 220,100,0
C 225,30,0


       111111111111111
      10011100000020001
     1000111000000200001
    100000000000000000001
   10000011100000000000011
  1000000011000001110111101
 111011111111101110000000001
11110111111111011100000000001
 111011111111101110000000001   11111
  1000000011000001110111101    11119
   10000011100000000000011     11111
    100000000000000000001
     1000111000000200001
      10011100000020N01
       111111111111111